############################################
#                            #             #
#              A             #     &       #
#   @          B             #             #
#              C             #             #
#              D             #             #
#   w                        #             #
#                                          #
############################################